abetted = abet + ted
aboveboard = above + board
aboveground = above + ground
abutted = abut + ted
acceptant = accept + ant
accession = access + ion
accordant = accord + ant
accordion = accord + ion
accountant = account + ant
accreditate = accredit + ate
acetate = ace + tate
acetic = ace + tic
acetone = ace + tone
acreage = acre + age
addend = add + end
admitted = admit + ted
adoption = adopt + ion
adsorbate = adsorb + ate
adulthood = adult + hood
affectate = affect + ate
affection = affect + ion
affectionate = affection + ate
agreeable = agree + able
airborne = air + borne
aircraft = air + craft
airdrop = air + drop
airfare = air + fare
airfield = air + field
airflow = air + flow
airfoil = air + foil
airframe = air + frame
airlift = air + lift
airline = air + line
airlock = air + lock
airmail = air + mail
airman = air + man
airmass = air + mass
airmen = air + men
airplane = air + plane
airport = air + port
airspace = air + space
airspeed = air + speed
airstrip = air + strip
airtight = air + tight
airway = air + way
albacore = alba + core
alderman = alder + man
aldermen = alder + men
alienate = alien + ate
alleyway = alley + way
alliterate = all + iterate
allotted = allot + ted
allspice = all + spice
alongside = along + side
alphabet = alpha + bet
alphanumeric = alpha + numeric
alterate = alter + ate
alterman = alter + man
alternate = altern + ate
amalgamate = amalgam + ate
amicable = ami + cable
ampere = amp + ere
anaglyph = ana + glyph
anchorage = anchor + age
andiron = and + iron
angelfish = angel + fish
aniline = ani + line
animate = ani + mate
annulled = annul + led
antacid = ant + acid
antarctic = ant + arctic
anteater = ant + eater
antebellum = ante + bellum
antedate = ante + date
antelope = ant + elope
antelope = ante + lope
anteroom = ante + room
anthem = ant + hem
anther = ant + her
anybody = any + body
anyhow = any + how
anyone = any + one
anyplace = any + place
anything = any + thing
anyway = any + way
anywhere = any + where
appendage = append + age
applejack = apple + jack
apportion = apport + ion
aqatic = aqa + tic
arcana = arc + ana
arccos = arc + cos
arccosine = arc + cosine
archangel = arch + angel
archbishop = arch + bishop
archdiocese = arch + diocese
archenemy = arch + enemy
archfool = arch + fool
archive = arc + hive
arclength = arc + length
arcsin = arc + sin
arcsine = arc + sine
arctan = arc + tan
arctangent = arc + tangent
arctangent = arctan + gent
arctic = arc + tic
areaway = are + away
areaway = area + way
areawide = area + wide
armchair = arm + chair
armhole = arm + hole
armload = arm + load
armpit = arm + pit
aromatic = aroma + tic
arrangeable = arrange + able
arrowhead = arrow + head
arrowroot = arrow + root
artwork = art + work
ascendant = ascend + ant
ashman = ash + man
ashmen = ash + men
ashore = ash + ore
ashtray = ash + tray
assail = ass + ail
assailant = assail + ant
assassinate = assassin + ate
assistant = assist + ant
attendant = attend + ant
audiotape = audio + tape
audiovisual = audio + visual
audition = audit + ion
authenticate = authentic + ate
autobiography = auto + biography
autocollimate = auto + collimate
autocorrelate = auto + correlate
autograph = auto + graph
automat = auto + mat
automate = auto + mate
automobile = auto + mobile
automorphism = auto + morphism
automotive = auto + motive
average = aver + age
averred = aver + red
averring = aver + ring
awesome = awe + some
babyhood = baby + hood
babysat = baby + sat
babysit = baby + sit
backboard = back + board
backbone = back + bone
backdrop = back + drop
backfill = back + fill
background = back + ground
backhand = back + hand
backlash = back + lash
backlog = back + log
backorder = back + order
backpack = back + pack
backplane = back + plane
backplate = back + plate
backside = back + side
backspace = back + space
backstage = back + stage
backstitch = back + stitch
backstop = back + stop
backtrack = back + track
backward = back + ward
backwater = back + water
backwood = back + wood
backyard = back + yard
badland = bad + land
baggage = bag + gage
bagpipe = bag + pipe
baldpate = bald + pate
ballfield = ball + field
ballroom = ball + room
bamboo = bam + boo
banana = ban + ana
bandage = band + age
bandgap = band + gap
bandpass = band + pass
bandstand = band + stand
bandstop = band + stop
bandwidth = band + width
baneberry = bane + berry
bantam = ban + tam
barbell = bar + bell
barbell = barb + ell
barberry = bar + berry
barefoot = bare + foot
barfly = bar + fly
bargain = bar + gain
barkeep = bar + keep
barnstorm = barn + storm
barnyard = barn + yard
barrack = bar + rack
barrage = bar + rage
barrow = bar + row
bartend = bar + tend
baseball = base + ball
baseband = base + band
baseboard = base + board
baseline = base + line
baseman = base + man
basemen = base + men
baseplate = base + plate
basepoint = base + point
basketball = basket + ball
bassinet = bassi + net
basswood = bass + wood
bathrobe = bath + robe
bathroom = bath + room
bathtub = bath + tub
batten = bat + ten
battlefield = battle + field
battlefront = battle + front
battleground = battle + ground
batwing = bat + wing
bayberry = bay + berry
beachcomb = beach + comb
beachhead = beach + head
bearberry = bear + berry
bedbug = bed + bug
bedevil = bed + evil
bedfast = bed + fast
bedlam = bed + lam
bedpost = bed + post
bedridden = bed + ridden
bedrock = bed + rock
bedroom = bed + room
bedside = bed + side
bedspread = bed + spread
bedspring = bed + spring
bedstraw = bed + straw
bedtime = bed + time
beebread = bee + bread
beechwood = beech + wood
beefsteak = beef + steak
beehive = bee + hive
beforehand = before + hand
beggar = beg + gar
beginner = beg + inner
belate = bel + ate
belfry = bel + fry
bellboy = bell + boy
bellhop = bell + hop
bellman = bell + man
bellmen = bell + men
bellow = bel + low
bellyache = belly + ache
bellyfull = belly + full
benchmark = bench + mark
bestirring = bestir + ring
bestseller = best + seller
bethought = beth + ought
betray = bet + ray
bettor = bet + tor
bidden = bid + den
billboard = bill + board
billfold = bill + fold
billion = bill + ion
binaural = bin + aural
bindweed = bind + weed
binocular = bin + ocular
birdbath = bird + bath
birdlike = bird + like
birdseed = bird + seed
birdwatch = bird + watch
birthday = birth + day
birthplace = birth + place
birthright = birth + right
bitnet = bit + net
bitten = bit + ten
bittern = bit + tern
bitwise = bit + wise
blackball = black + ball
blackberry = black + berry
blackbird = black + bird
blackboard = black + board
blackbody = black + body
blackjack = black + jack
blackmail = black + mail
blackout = black + out
blacksmith = black + smith
bladdernut = bladder + nut
blameworthy = blame + worthy
blatant = blat + ant
blather = blat + her
blindfold = blind + fold
blockage = block + age
blockhouse = block + house
bloodbath = blood + bath
bloodhound = blood + hound
bloodline = blood + line
bloodroot = blood + root
bloodshed = blood + shed
bloodshot = blood + shot
bloodstain = blood + stain
bloodstone = blood + stone
bloodstream = blood + stream
blowback = blow + back
blowfish = blow + fish
blueback = blue + back
blueberry = blue + berry
bluebill = blue + bill
bluebird = blue + bird
bluebonnet = blue + bonnet
bluebook = blue + book
bluebush = blue + bush
bluefish = blue + fish
bluegill = blue + gill
bluegrass = blue + grass
bluejacket = blue + jacket
blueprint = blue + print
boathouse = boat + house
boatload = boat + load
boatman = boat + man
boatmen = boat + men
boatswain = boat + swain
boatyard = boat + yard
bobbin = bob + bin
bobcat = bob + cat
bodybuild = body + build
bodyguard = body + guard
bogeymen = bogey + men
boldface = bold + face
bolometer = bolo + meter
bombproof = bomb + proof
bondage = bond + age
bonfire = bon + fire
bonnet = bon + net
bookbind = book + bind
bookcase = book + case
bookend = book + end
bookkeep = book + keep
booklet = book + let
bookmobile = book + mobile
bookplate = book + plate
bookseller = book + seller
bookshelf = book + shelf
bookstore = book + store
boolean = boo + lean
bootleg = boot + leg
bootlegging = boot + legging
bootstrap = boot + strap
bootstrapping = bootstrap + ping
borderland = border + land
borderline = border + line
bottleneck = bottle + neck
bottommost = bottom + most
bowfin = bow + fin
bowline = bow + line
bowman = bow + man
bowmen = bow + men
bowstring = bow + string
boxcar = box + car
boxwood = box + wood
boyfriend = boy + friend
boyhood = boy + hood
bracelet = brace + let
brainchild = brain + child
brainchildren = brain + children
brainstorm = brain + storm
brainwash = brain + wash
brakeman = brake + man
brandish = bran + dish
brandywine = brandy + wine
breadboard = bread + board
breadfruit = bread + fruit
breadroot = bread + root
breakage = break + age
breakaway = break + away
breakdown = break + down
breakfast = break + fast
breakoff = break + off
breakpoint = break + point
breakthrough = break + through
breakwater = break + water
brickbat = brick + bat
bricklay = brick + lay
bridegroom = bride + groom
bridgeable = bridge + able
bridgehead = bridge + head
bridgework = bridge + work
briefcase = brief + case
brimstone = brim + stone
broadcast = broad + cast
broadloom = broad + loom
broadside = broad + side
brokerage = broke + rage
brookside = brook + side
broomcorn = broom + corn
brotherhood = brother + hood
browbeaten = brow + beaten
brushfire = brush + fire
brushlike = brush + like
brushwork = brush + work
buckboard = buck + board
bucketfull = bucket + full
buckeye = buck + eye
buckhorn = buck + horn
buckshot = buck + shot
buckskin = buck + skin
buckthorn = buck + thorn
buckwheat = buck + wheat
budget = bud + get
bugeyed = bug + eyed
bulblet = bulb + let
bulkhead = bulk + head
bulldog = bull + dog
bulldoze = bull + doze
bullfinch = bull + finch
bullfrog = bull + frog
bullhead = bull + head
bullhide = bull + hide
bullwhack = bull + whack
bullyboy = bully + boy
bumblebee = bumble + bee
bunkmate = bunk + mate
buoyant = buoy + ant
burdensome = burden + some
burgher = burg + her
burglarproof = burglar + proof
burnout = burn + out
busboy = bus + boy
bushwhack = bush + whack
businessman = business + man
businessmen = business + men
button = but + ton
buttonhole = button + hole
buttonweed = button + weed
buttress = but + tress
buzzsaw = buzz + saw
buzzword = buzz + word
cabana = cab + ana
cabinetmake = cabinet + make
calfskin = calf + skin
caliphate = caliph + ate
camelback = camel + back
camera = cam + era
cameraman = camera + man
cameramen = camera + men
campfire = camp + fire
campground = camp + ground
campion = cam + pion
campion = camp + ion
campsite = camp + site
campus = cam + pus
cancellate = cancel + late
cancelled = cancel + led
candid = can + did
candidate = candid + ate
candlelight = candle + light
candlelit = candle + lit
candlestick = candle + stick
candlewick = candle + wick
cankerworm = canker + worm
cannon = can + non
cannonball = cannon + ball
cannot = can + not
canteen = can + teen
canton = can + ton
cantor = can + tor
canvasback = canvas + back
canyon = can + yon
caprice = cap + rice
capsize = cap + size
capstone = cap + stone
captor = cap + tor
caraway = car + away
carbide = car + bide
carbon = car + bon
carbonate = carbon + ate
carboxy = car + boxy
carboy = car + boy
cardboard = card + board
carefree = care + free
careworn = care + worn
carfare = car + fare
cargoes = car + goes
carload = car + load
carmine = car + mine
carnation = car + nation
carpenter = carp + enter
carpentry = carp + entry
carpet = car + pet
carport = car + port
carrot = car + rot
carryover = carry + over
carton = car + ton
cartridge = cart + ridge
cartwheel = cart + wheel
casebook = case + book
casework = case + work
cashmere = cash + mere
catbird = cat + bird
catcall = cat + call
catchword = catch + word
caterpillar = cater + pillar
catfish = cat + fish
cation = cat + ion
cationic = cat + ionic
catkin = cat + kin
catlike = cat + like
catnip = cat + nip
catsup = cat + sup
cattail = cat + tail
cattleman = cattle + man
cattlemen = cattle + men
caveman = cave + man
cavemen = cave + men
chairlady = chair + lady
chairman = chair + man
chairmen = chair + men
chairperson = chair + person
chairwoman = chair + woman
chairwomen = chair + women
chalkboard = chalk + board
chalkline = chalk + line
chamberlain = chamber + lain
chambermaid = chamber + maid
champion = champ + ion
changeable = change + able
changeover = change + over
chaplain = chap + lain
charcoal = char + coal
chargeable = charge + able
charismatic = charisma + tic
chartroom = chart + room
checkbook = check + book
checklist = check + list
checkmate = check + mate
checkout = check + out
checkpoint = check + point
checksum = check + sum
cheekbone = cheek + bone
cheerlead = cheer + lead
cheesecake = cheese + cake
cheesecloth = cheese + cloth
chestnut = chest + nut
chianti = chi + anti
chicken = chic + ken
chickweed = chick + weed
childbear = child + bear
childbirth = child + birth
childhood = child + hood
childlike = child + like
chipboard = chip + board
chiton = chi + ton
chokeberry = choke + berry
chordate = chord + ate
churchgoer = church + goer
churchman = church + man
churchmen = church + men
churchwoman = church + woman
churchwomen = church + women
churchyard = church + yard
cinematic = cinema + tic
circumvention = circumvent + ion
citrate = cit + rate
citywide = city + wide
claimant = claim + ant
clamshell = clam + shell
clandestine = clan + destine
clapboard = clap + board
classmate = class + mate
classroom = class + room
clergyman = clergy + man
clergymen = clergy + men
cliffhang = cliff + hang
clipboard = clip + board
cloakroom = cloak + room
clockwise = clock + wise
clockwork = clock + work
cloddish = clod + dish
clothbound = cloth + bound
cloudburst = cloud + burst
clubhouse = club + house
clubroom = club + room
coachman = coach + man
coachmen = coach + men
coachwork = coach + work
coastline = coast + line
coattail = coat + tail
cobblestone = cobble + stone
cockcrow = cock + crow
cockeye = cock + eye
cockleshell = cockle + shell
cockpit = cock + pit
cockroach = cock + roach
cocksure = cock + sure
cocktail = cock + tail
coconut = coco + nut
codebreak = code + break
codeposit = code + posit
codeword = code + word
codfish = cod + fish
codpiece = cod + piece
coffeecup = coffee + cup
coffeepot = coffee + pot
coinage = coin + age
colicky = col + icky
collapse = col + lapse
collarbone = collar + bone
collard = col + lard
collate = col + late
collateral = col + lateral
colleague = col + league
collet = col + let
collie = col + lie
collinear = col + linear
colorate = col + orate
combatant = combat + ant
combatted = combat + ted
comeback = come + back
commandant = command + ant
committable = commit + table
committed = commit + ted
committee = commit + tee
committeeman = committee + man
committeemen = committee + men
committeewoman = committee + woman
committeewomen = committee + women
commonplace = common + place
commonweal = common + weal
commonwealth = common + wealth
companionway = companion + way
compassion = compass + ion
compassionate = compassion + ate
compelled = compel + led
complainant = complain + ant
complexion = complex + ion
compression = compress + ion
concatenate = con + catenate
concave = con + cave
concede = con + cede
concentric = con + centric
conception = concept + ion
concession = con + cession
conciliate = con + ciliate
concord = con + cord
concordant = concord + ant
concourse = con + course
concur = con + cur
concurred = concur + red
concurrent = con + current
concurrent = concur + rent
concurring = concur + ring
condemnate = condemn + ate
condense = con + dense
condescend = con + descend
condone = con + done
conduct = con + duct
confederate = con + federate
conferred = confer + red
conferring = confer + ring
confession = confess + ion
confide = con + fide
configure = con + figure
confine = con + fine
confirm = con + firm
confluent = con + fluent
confocal = con + focal
conform = con + form
conformal = con + formal
confound = con + found
confront = con + front
confuse = con + fuse
confusion = con + fusion
congenial = con + genial
congenital = con + genital
congestion = congest + ion
congressman = congress + man
congressmen = congress + men
congresswoman = congress + woman
congresswomen = congress + women
conjoin = con + join
conjoint = con + joint
conjugate = con + jugate
conjuncture = con + juncture
conjure = con + jure
connote = con + note
conquest = con + quest
consanguine = con + sanguine
consanguineous = con + sanguineous
conscience = con + science
conscript = con + script
conscription = con + scription
conscription = conscript + ion
consent = con + sent
consequent = con + sequent
consequential = con + sequential
conserve = con + serve
considerate = consider + ate
consign = con + sign
console = con + sole
consonant = con + sonant
consort = con + sort
conspire = con + spire
constrain = con + strain
constrict = con + strict
consulate = consul + ate
consultant = consult + ant
consummate = con + summate
contact = con + tact
contemplate = con + template
contemporary = con + temporary
contempt = con + tempt
contend = con + tend
content = con + tent
contention = content + ion
contest = con + test
contestant = contest + ant
context = con + text
contextual = con + textual
contort = con + tort
contour = con + tour
contract = con + tract
contractor = con + tractor
contribute = con + tribute
contrite = con + trite
controlled = control + led
convent = con + vent
convention = convent + ion
converge = con + verge
converse = con + verse
conversion = con + version
convex = con + vex
convocate = con + vocate
cookbook = cook + book
coolant = cool + ant
copybook = copy + book
copyright = copy + right
coralberry = coral + berry
coralline = coral + line
cordage = cord + age
corkscrew = cork + screw
cornbread = corn + bread
cornfield = corn + field
cornmeal = corn + meal
cornstarch = corn + starch
corpsman = corps + man
corpsmen = corps + men
corralled = corral + led
corruption = corrupt + ion
cotman = cot + man
cotton = cot + ton
cottonmouth = cotton + mouth
cottonseed = cotton + seed
cottonwood = cotton + wood
cottony = cot + tony
councilman = council + man
councilmen = council + men
councilwoman = council + woman
councilwomen = council + women
countdown = count + down
countryman = country + man
countrymen = country + men
countryside = country + side
countrywide = country + wide
countywide = county + wide
courthouse = court + house
courtroom = court + room
courtyard = court + yard
covenant = coven + ant
coverage = cove + rage
coverage = cover + age
coverall = cover + all
coverlet = cover + let
cowardice = coward + ice
cowbell = cow + bell
cowbird = cow + bird
cowboy = cow + boy
cowgirl = cow + girl
cowhand = cow + hand
cowherd = cow + herd
cowhide = cow + hide
cowlick = cow + lick
cowman = cow + man
cowmen = cow + men
cowpea = cow + pea
cowpoke = cow + poke
cowpony = cow + pony
cowpunch = cow + punch
cowslip = cow + slip
coxcomb = cox + comb
crabapple = crab + apple
crabmeat = crab + meat
crackpot = crack + pot
cranelike = crane + like
crankcase = crank + case
crankshaft = crank + shaft
crappie = crap + pie
crawlspace = crawl + space
creekside = creek + side
crestfallen = crest + fallen
crewcut = crew + cut
crewman = crew + man
crewmen = crew + men
crisscross = criss + cross
crossarm = cross + arm
crossbar = cross + bar
crossbill = cross + bill
crossbow = cross + bow
crosscut = cross + cut
crosshatch = cross + hatch
crosslink = cross + link
crossover = cross + over
crosspoint = cross + point
crossroad = cross + road
crosstalk = cross + talk
crosswalk = cross + walk
crossway = cross + way
crosswise = cross + wise
crossword = cross + word
crowbait = crow + bait
crowberry = crow + berry
crowfoot = crow + foot
crucifixion = crucifix + ion
cryptanalysis = crypt + analysis
cryptanalyst = crypt + analyst
cryptanalytic = crypt + analytic
crystalline = crystal + line
cudgel = cud + gel
cufflink = cuff + link
cupboard = cup + board
curate = cur + ate
curbside = curb + side
curfew = cur + few
curlew = cur + lew
currant = cur + rant
current = cur + rent
curtail = cur + tail
curtail = curt + ail
customhouse = custom + house
cutback = cut + back
cutlass = cut + lass
cutlet = cut + let
cutoff = cut + off
cutout = cut + out
cutover = cut + over
cutset = cut + set
cutthroat = cut + throat
cutworm = cut + worm
dairyman = dairy + man
dairymen = dairy + men
damage = dam + age
damask = dam + ask
dampen = dam + pen
daredevil = dare + devil
dashboard = dash + board
database = data + base
dateline = date + line
daybed = day + bed
daybreak = day + break
daydream = day + dream
daylight = day + light
daytime = day + time
deadhead = dead + head
deadline = dead + line
deadlock = dead + lock
deadwood = dead + wood
deallocate = deal + locate
deathbed = death + bed
deathward = death + ward
debarring = debar + ring
debutante = debut + ante
decisionmake = decision + make
decompression = decompress + ion
decontrolled = decontrol + led
decorate = decor + ate
decryption = decrypt + ion
deerskin = deer + skin
defendant = defend + ant
deferred = defer + red
deferring = defer + ring
degassing = degas + sing
demitted = demit + ted
demurred = demur + red
demurring = demur + ring
denounce = den + ounce
deposition = deposit + ion
depressant = depress + ant
depression = depress + ion
descendant = descend + ant
designate = design + ate
detention = detent + ion
detergent = deter + gent
determine = deter + mine
deterred = deter + red
deterrent = deter + rent
deterring = deter + ring
dewdrop = dew + drop
diehard = die + hard
digestion = digest + ion
digitate = digit + ate
digram = dig + ram
digression = digress + ion
dimethyl = dim + ethyl
diplomatic = diploma + tic
directorate = direct + orate
directorate = director + ate
discovery = disco + very
discussant = discuss + ant
discussion = discuss + ion
dishwater = dish + water
dispelled = dispel + led
disruption = disrupt + ion
distortion = distort + ion
divalent = diva + lent
dockside = dock + side
dockyard = dock + yard
doctorate = doctor + ate
dogbane = dog + bane
dogberry = dog + berry
dogfish = dog + fish
doggone = dog + gone
doghouse = dog + house
dogleg = dog + leg
dogmatic = dogma + tic
dogtooth = dog + tooth
dogtrot = dog + trot
dogwood = dog + wood
domesticate = domestic + ate
donate = don + ate
donkey = don + key
doorbell = door + bell
doorkeep = door + keep
doorknob = door + knob
doorman = door + man
doormen = door + men
doorstep = door + step
doorway = door + way
doubleton = double + ton
doughnut = dough + nut
dovetail = dove + tail
downbeat = down + beat
downcast = down + cast
downdraft = down + draft
downfall = down + fall
downgrade = down + grade
downhill = down + hill
downplay = down + play
downpour = down + pour
downright = down + right
downriver = down + river
downside = down + side
downslope = down + slope
downspout = down + spout
downstate = down + state
downstream = down + stream
downtown = down + town
downtrend = down + trend
downtrodden = down + trodden
downturn = down + turn
downward = down + ward
downwind = down + wind
dragnet = drag + net
dragonfly = dragon + fly
dragonhead = dragon + head
drainage = drain + age
dramatic = drama + tic
drawback = draw + back
drawbridge = draw + bridge
dreamboat = dream + boat
dreamlike = dream + like
dressmake = dress + make
driveway = drive + way
drophead = drop + head
droplet = drop + let
dropout = drop + out
drugstore = drug + store
drumhead = drum + head
ductwork = duct + work
dugout = dug + out
dumbbell = dumb + bell
dustbin = dust + bin
eardrum = ear + drum
earmark = ear + mark
earnest = ear + nest
earphone = ear + phone
earring = ear + ring
earthen = ear + then
earthenware = earthen + ware
earthmen = earth + men
earthmove = earth + move
earthquake = earth + quake
earthworm = earth + worm
earthy = ear + thy
earwig = ear + wig
eastbound = east + bound
easternmost = eastern + most
eastward = east + ward
eavesdropper = eavesdrop + per
eavesdropping = eavesdrop + ping
edgewise = edge + wise
edition = edit + ion
eelgrass = eel + grass
effaceable = efface + able
egghead = egg + head
eggplant = egg + plant
eggshell = egg + shell
egocentric = ego + centric
eightfold = eight + fold
electoral = elect + oral
electorate = elect + orate
electorate = elector + ate
electret = elect + ret
electrode = elect + rode
elsewhere = else + where
embedding = embed + ding
embraceable = embrace + able
emitted = emit + ted
endgame = end + game
endpoint = end + point
enigmatic = enigma + tic
equipping = equip + ping
erasable = era + sable
erasure = era + sure
errand = err + and
errant = err + ant
eruption = erupt + ion
estoppal = estop + pal
evensong = even + song
eventide = even + tide
everybody = every + body
everyday = every + day
everyman = every + man
everyone = every + one
everything = every + thing
everywhere = every + where
excelled = excel + led
excellent = excel + lent
exception = except + ion
exchangeable = exchange + able
exemption = exempt + ion
exhaustion = exhaust + ion
exhibition = exhibit + ion
expectant = expect + ant
expectorate = expect + orate
expelled = expel + led
exposition = exposit + ion
expression = express + ion
expressway = express + way
extolled = extol + led
extracellular = extra + cellular
extralegal = extra + legal
extramarital = extra + marital
extramural = extra + mural
extraordinary = extra + ordinary
exultant = exult + ant
eyeball = eye + ball
eyebright = eye + bright
eyebrow = eye + brow
eyeglass = eye + glass
eyelash = eye + lash
eyelet = eye + let
eyelid = eye + lid
eyepiece = eye + piece
eyesight = eye + sight
eyesore = eye + sore
eyewitness = eye + witness
fabricate = fabric + ate
faceplate = face + plate
fadeout = fade + out
failsafe = fail + safe
failsoft = fail + soft
fairgoer = fair + goer
fairway = fair + way
falloff = fall + off
fallout = fall + out
falsehood = false + hood
fanfare = fan + fare
fanfold = fan + fold
fangled = fang + led
fanout = fan + out
farewell = fare + well
farmhouse = farm + house
farmland = farm + land
father = fat + her
fatten = fat + ten
fearsome = fear + some
feather = feat + her
featherbed = feather + bed
featherbedding = featherbed + ding
featherbrain = feather + brain
feathertop = feather + top
featherweight = feather + weight
feedback = feed + back
fencepost = fence + post
fiddlestick = fiddle + stick
fieldstone = field + stone
fieldwork = field + work
figurine = fig + urine
filmmake = film + make
filmstrip = film + strip
finale = fin + ale
fingernail = finger + nail
fingerprint = finger + print
fingertip = finger + tip
finicky = fin + icky
firearm = fire + arm
fireboat = fire + boat
firebreak = fire + break
firebug = fire + bug
firefly = fire + fly
firehouse = fire + house
firelight = fire + light
fireman = fire + man
firemen = fire + men
fireplace = fire + place
firepower = fire + power
fireproof = fire + proof
fireside = fire + side
firewall = fire + wall
firewood = fire + wood
firework = fire + work
firmware = firm + ware
firsthand = first + hand
fishpond = fish + pond
fivefold = five + fold
fixate = fix + ate
flagpole = flag + pole
flagrant = flag + rant
flagstone = flag + stone
flashback = flash + back
flashlight = flash + light
flatbed = flat + bed
flathead = flat + head
flatiron = flat + iron
flatland = flat + land
flatten = flat + ten
flatware = flat + ware
flatworm = flat + worm
flaxseed = flax + seed
fleabane = flea + bane
flintlock = flint + lock
flipflop = flip + flop
flippant = flip + pant
floodgate = flood + gate
floodlight = flood + light
floodlit = flood + lit
floorboard = floor + board
flowchart = flow + chart
fluvial = flu + vial
flyway = fly + way
foldout = fold + out
folklore = folk + lore
folksong = folk + song
foodstuff = food + stuff
foolhardy = fool + hardy
foolproof = fool + proof
footage = foot + age
football = foot + ball
footbridge = foot + bridge
footfall = foot + fall
foothill = foot + hill
footman = foot + man
footmen = foot + men
footnote = foot + note
footpad = foot + pad
footpath = foot + path
footprint = foot + print
footstep = foot + step
footstool = foot + stool
footwear = foot + wear
footwork = foot + work
forage = for + age
forbade = for + bade
forbear = for + bear
forbid = for + bid
forbidden = for + bidden
forbidden = forbid + den
forbidding = forbid + ding
forbore = for + bore
forborne = for + borne
forfend = for + fend
forgave = for + gave
forget = for + get
forgettable = forget + table
forgive = for + give
forgiven = for + given
forgot = for + got
forgotten = for + gotten
forgotten = forgot + ten
forklift = fork + lift
formaldehyde = form + aldehyde
formant = form + ant
format = for + mat
formate = for + mate
formate = form + ate
formatted = format + ted
forsake = for + sake
forswear = for + swear
forthcome = forth + come
forthright = forth + right
forthwith = forth + with
fortin = for + tin
fortnight = fort + night
fortran = fort + ran
fortress = for + tress
fortune = for + tune
forward = for + ward
forwent = for + went
foulmouth = foul + mouth
fountainhead = fountain + head
fourfold = four + fold
foursome = four + some
foursquare = four + square
fourteen = four + teen
foxglove = fox + glove
foxhole = fox + hole
foxhound = fox + hound
foxtail = fox + tail
fractionate = fraction + ate
framework = frame + work
freeboot = free + boot
freedmen = freed + men
freehand = free + hand
freehold = free + hold
freeman = free + man
freemen = free + men
freestone = free + stone
freestone = freest + one
freethink = free + think
freeway = free + way
freewheel = free + wheel
freshman = fresh + man
freshmen = fresh + men
freshwater = fresh + water
frontage = front + age
frostbite = frost + bite
frostbitten = frost + bitten
frothy = fro + thy
fruition = fruit + ion
fullback = full + back
fundraise = fund + raise
fungal = fun + gal
furlong = fur + long
furrow = fur + row
furthermore = further + more
furthermost = further + most
gadfly = gad + fly
gadget = gad + get
gadwall = gad + wall
gallant = gall + ant
gallberry = gall + berry
gallonage = gallon + age
gallop = gal + lop
gallstone = gall + stone
gambit = gam + bit
gamecock = game + cock
gangland = gang + land
ganglion = gang + lion
gangplank = gang + plank
gangway = gang + way
garage = gar + age
garbage = garb + age
garden = gar + den
garland = gar + land
garnet = gar + net
gaslight = gas + light
gatekeep = gate + keep
gateway = gate + way
gaugeable = gauge + able
gauntlet = gaunt + let
gelable = gel + able
gemlike = gem + like
gemstone = gem + stone
generate = gene + rate
genesis = gene + sis
genetic = gene + tic
genteel = gent + eel
gentleman = gentle + man
gentlemen = gentle + men
getaway = get + away
ghostlike = ghost + like
gigantic = gig + antic
ginmill = gin + mill
giveaway = give + away
gladden = glad + den
glassware = glass + ware
glutton = glut + ton
glycerinate = glycerin + ate
goatherd = goat + herd
goblet = gob + let
godfather = god + father
godhead = god + head
godkin = god + kin
godlike = god + like
godmother = god + mother
godparent = god + parent
godsend = god + send
godson = god + son
godwit = god + wit
goldeneye = golden + eye
goldenrod = golden + rod
goldenseal = golden + seal
goldfinch = gold + finch
goldfish = gold + fish
goldsmith = gold + smith
goodbye = good + bye
goodwill = good + will
gooseberry = goose + berry
gotten = got + ten
gradate = grad + ate
grandchild = grand + child
grandchildren = grand + children
granddaughter = grand + daughter
grandfather = grand + father
grandmother = grand + mother
grandnephew = grand + nephew
grandniece = grand + niece
grandparent = grand + parent
grandparent = grandpa + rent
grandson = grand + son
grandstand = grand + stand
grapefruit = grape + fruit
grapevine = grape + vine
grassland = grass + land
gravestone = grave + stone
graveyard = grave + yard
graybeard = gray + beard
graywacke = gray + wacke
greatcoat = great + coat
greengrocer = green + grocer
greenhouse = green + house
greenware = green + ware
greenwood = green + wood
greyhound = grey + hound
greylag = grey + lag
gridiron = grid + iron
grillwork = grill + work
grimace = grim + ace
grindstone = grind + stone
gristmill = grist + mill
groundwork = ground + work
guardhouse = guard + house
guesswork = guess + work
guidebook = guide + book
guideline = guide + line
guidepost = guide + post
guildhall = guild + hall
gumdrop = gum + drop
gumshoe = gum + shoe
gunfight = gun + fight
gunfire = gun + fire
gunflint = gun + flint
gunman = gun + man
gunmen = gun + men
gunplay = gun + play
gunpowder = gun + powder
gunshot = gun + shot
gunsling = gun + sling
gypsite = gyp + site
gypsum = gyp + sum
gyrocompass = gyro + compass
gyroscope = gyro + scope
habitant = habit + ant
habitation = habitat + ion
hackberry = hack + berry
hacksaw = hack + saw
haddock = had + dock
hailstone = hail + stone
hailstorm = hail + storm
haircut = hair + cut
hairpin = hair + pin
halfback = half + back
halfway = half + way
hallmark = hall + mark
hallway = hall + way
halocarbon = halo + carbon
hamlet = ham + let
hammock = ham + mock
hamper = ham + per
handbag = hand + bag
handbook = hand + book
handclasp = hand + clasp
handcuff = hand + cuff
handgun = hand + gun
handhold = hand + hold
handicapper = handicap + per
handicapping = handicap + ping
handkerchief = hand + kerchief
handleable = handle + able
handlebar = handle + bar
handline = hand + line
handmade = hand + made
handmaiden = hand + maiden
handout = hand + out
handset = hand + set
handshake = hand + shake
handsome = hand + some
handspike = hand + spike
handstand = hand + stand
handwrite = hand + write
handwritten = hand + written
handyman = handy + man
handymen = handy + men
hangable = hang + able
hangman = hang + man
hangmen = hang + men
hangout = hang + out
hangover = hang + over
haphazard = hap + hazard
happen = hap + pen
happenstance = happen + stance
hardbake = hard + bake
hardboard = hard + board
hardcopy = hard + copy
hardhat = hard + hat
hardscrabble = hard + scrabble
hardtack = hard + tack
hardtop = hard + top
hardware = hard + ware
hardwood = hard + wood
harelip = hare + lip
harvestman = harvest + man
hatchway = hatch + way
hatred = hat + red
haulage = haul + age
hawthorn = haw + thorn
hayfield = hay + field
haystack = hay + stack
hayward = hay + ward
hazelnut = hazel + nut
headache = head + ache
headboard = head + board
headdress = head + dress
headland = head + land
headlight = head + light
headline = head + line
headphone = head + phone
headroom = head + room
headset = head + set
headstand = head + stand
headstone = head + stone
headstrong = head + strong
headwall = head + wall
headwater = head + water
headway = head + way
headwind = head + wind
healthy = heal + thy
hearken = hear + ken
hearsay = hear + say
heartbeat = heart + beat
heartbreak = heart + break
hearten = hear + ten
heartfelt = heart + felt
heathen = heat + hen
heavenward = heaven + ward
heavyweight = heavy + weight
hedgehog = hedge + hog
heighten = heigh + ten
hellfire = hell + fire
helpmate = help + mate
hemlock = hem + lock
henbane = hen + bane
henceforth = hence + forth
henpeck = hen + peck
hereabout = here + about
hereinabove = herein + above
hereinbelow = herein + below
heretic = here + tic
heretofore = hereto + fore
hereunder = here + under
herewith = here + with
herself = her + self
heyday = hey + day
hidden = hid + den
hideaway = hide + away
hideout = hide + out
highball = high + ball
highboy = high + boy
highland = high + land
highlight = high + light
highroad = high + road
hightail = high + tail
highway = high + way
highwayman = highway + man
highwaymen = highway + men
hillbilly = hill + billy
hillman = hill + man
hillmen = hill + men
hillside = hill + side
hilltop = hill + top
himself = him + self
hindmost = hind + most
hindsight = hind + sight
history = his + tory
hither = hit + her
hoarfrost = hoar + frost
hobbyhorse = hobby + horse
hockey = hoc + key
hodgepodge = hodge + podge
holdout = hold + out
holdover = hold + over
holeable = hole + able
hollowware = hollow + ware
hollyhock = holly + hock
homebound = home + bound
homebuild = home + build
homecome = home + come
homeland = home + land
homemade = home + made
homemake = home + make
homeown = home + own
homesick = home + sick
homestead = home + stead
homeward = home + ward
homework = home + work
homomorphism = homo + morphism
homosexual = homo + sexual
honeybee = honey + bee
honeycomb = honey + comb
honeydew = honey + dew
honeymoon = honey + moon
hoofmark = hoof + mark
hookworm = hook + worm
hopscotch = hop + scotch
hornbeam = horn + beam
hornmouth = horn + mouth
horntail = horn + tail
horseback = horse + back
horseflesh = horse + flesh
horsefly = horse + fly
horsehair = horse + hair
horseman = horse + man
horsemen = horse + men
horseplay = horse + play
horsepower = horse + power
horseshoe = horse + shoe
horsetail = horse + tail
horsewoman = horse + woman
horsewomen = horse + women
hostage = host + age
hotbed = hot + bed
hotbox = hot + box
hotelman = hotel + man
hothead = hot + head
hothouse = hot + house
hotrod = hot + rod
hotshot = hot + shot
hourglass = hour + glass
houseboat = house + boat
housebreak = house + break
housebroken = house + broken
housefly = house + fly
household = house + hold
housekeep = house + keep
housewife = house + wife
housework = house + work
hoyden = hoy + den
hubbub = hub + bub
hummock = hum + mock
humpback = hump + back
hundredfold = hundred + fold
husbandman = husband + man
husbandmen = husband + men
hydrocarbon = hydro + carbon
hydrochemistry = hydro + chemistry
hydrochloride = hydro + chloride
hydrodynamic = hydro + dynamic
hydroelectric = hydro + electric
hydrogenate = hydrogen + ate
hydrometer = hydro + meter
hydrophobic = hydro + phobic
hydrosphere = hydro + sphere
hydrostatic = hydro + static
hydrothermal = hydro + thermal
hydroxylate = hydroxy + late
hydroxylate = hydroxyl + ate
hyphenate = hyphen + ate
iceberg = ice + berg
icebox = ice + box
iceland = ice + land
illimitable = ill + imitable
illiterate = ill + iterate
impact = imp + act
impair = imp + air
impale = imp + ale
impart = imp + art
impeach = imp + each
impelled = impel + led
impend = imp + end
implore = imp + lore
important = import + ant
impression = impress + ion
improve = imp + rove
impunity = imp + unity
incurred = incur + red
incurring = incur + ring
infantryman = infantry + man
infantrymen = infantry + men
inferred = infer + red
inferring = infer + ring
infertile = infer + tile
informant = inform + ant
infrared = infra + red
infrastructure = infra + structure
ingestion = ingest + ion
inhabitant = inhabit + ant
inhibition = inhibit + ion
injunction = injunct + ion
innate = inn + ate
innermost = inner + most
innovate = inn + ovate
insurrection = insurrect + ion
intendant = intend + ant
intention = intent + ion
interception = intercept + ion
intermittent = intermit + tent
interruption = interrupt + ion
intersect = inter + sect
intuitable = intuit + able
intuition = intuit + ion
invalidate = invalid + ate
invention = invent + ion
irksome = irk + some
ironside = iron + side
ironstone = iron + stone
ironwood = iron + wood
jackass = jack + ass
jackboot = jack + boot
jackknife = jack + knife
jackpot = jack + pot
jawbone = jaw + bone
jawbreak = jaw + break
jellyfish = jelly + fish
jigsaw = jig + saw
jitterbug = jitter + bug
jitterbugging = jitter + bugging
jockstrap = jock + strap
journeyman = journey + man
journeymen = journey + men
joyride = joy + ride
joystick = joy + stick
jugate = jug + ate
justice = just + ice
keelson = keel + son
keyboard = key + board
keyhole = key + hole
keynote = key + note
keypunch = key + punch
keystone = key + stone
keystone = keys + tone
keyword = key + word
kickback = kick + back
kickoff = kick + off
kiddie = kid + die
kidnap = kid + nap
kidnapping = kidnap + ping
killdeer = kill + deer
killjoy = kill + joy
kindred = kind + red
kingbird = king + bird
kinglet = king + let
kingpin = king + pin
kitten = kit + ten
kneecap = knee + cap
knifelike = knife + like
knockdown = knock + down
knockout = knock + out
knowhow = know + how
knowledge = know + ledge
knowledgeable = knowledge + able
knuckleball = knuckle + ball
laboratory = lab + oratory
labour = lab + our
lacerate = lace + rate
lacewing = lace + wing
lackey = lac + key
lactate = lac + tate
ladyfern = lady + fern
ladylike = lady + like
lakeside = lake + side
lampblack = lamp + black
lamplight = lam + plight
lamplight = lamp + light
lamprey = lam + prey
landfill = land + fill
landhold = land + hold
landlord = land + lord
landmark = land + mark
landslide = land + slide
lapelled = lapel + led
lappet = lap + pet
largemouth = large + mouth
larkspur = lark + spur
laterite = late + rite
lavatory = lava + tory
lawbreak = law + break
lawgive = law + give
lawmake = law + make
lawman = law + man
lawmen = law + men
lawsuit = law + suit
layman = lay + man
laymen = lay + men
layoff = lay + off
layout = lay + out
leachate = leach + ate
leaden = lea + den
leaflet = leaf + let
leakage = leak + age
leapfrog = leap + frog
leasehold = lease + hold
leatherback = leather + back
leatherneck = leather + neck
leatherwork = leather + work
leeward = lee + ward
leeway = lee + way
leftmost = left + most
leftover = left + over
leftward = left + ward
legate = leg + ate
legend = leg + end
leghorn = leg + horn
legion = leg + ion
lengthwise = length + wise
leverage = lever + age
lieutenant = lieu + tenant
lifeblood = life + blood
lifeboat = life + boat
lifeguard = life + guard
lifelike = life + like
lifelong = life + long
lifespan = life + span
lifestyle = life + style
lifetime = life + time
lightface = light + face
lighthouse = light + house
lightproof = light + proof
lightweight = light + weight
likewise = like + wise
limelight = lime + light
limestone = lime + stone
limitate = limit + ate
limpet = lim + pet
limpkin = limp + kin
lineage = line + age
lineman = line + man
linemen = line + men
linkage = link + age
lipread = lip + read
lipstick = lip + stick
liquidate = liquid + ate
litany = lit + any
littleneck = little + neck
livestock = live + stock
loathsome = loath + some
loblolly = lob + lolly
locknut = lock + nut
lockout = lock + out
locksmith = lock + smith
lockstep = lock + step
lodgepole = lodge + pole
logjam = log + jam
loincloth = loin + cloth
lonesome = lone + some
longhand = long + hand
longhorn = long + horn
longleg = long + leg
longtime = long + time
lookout = look + out
loophole = loop + hole
looseleaf = loose + leaf
loosestrife = loose + strife
lopseed = lop + seed
lotion = lot + ion
loudspeak = loud + speak
lovebird = love + bird
lowboy = low + boy
lowdown = low + down
lowland = low + land
luggage = lug + gage
lukewarm = luke + warm
lumberman = lumber + man
lumbermen = lumber + men
lunchroom = lunch + room
lunchtime = lunch + time
machinelike = machine + like
macromolecular = macro + molecular
macromolecule = macro + molecule
macrophage = macro + phage
macroprocessor = macro + processor
macroscopic = macro + scopic
macrostructure = macro + structure
madcap = mad + cap
madden = mad + den
madhouse = mad + house
madman = mad + man
madmen = mad + men
madstone = mad + stone
maidenhair = maiden + hair
maidservant = maid + servant
mailbox = mail + box
mailman = mail + man
mailmen = mail + men
mainland = main + land
mainline = main + line
mainstay = main + stay
mainstream = main + stream
makeshift = make + shift
malefactor = male + factor
malignant = malign + ant
manage = man + age
manageable = manage + able
manatee = mana + tee
mandate = man + date
mandrake = man + drake
mandrill = man + drill
mangel = man + gel
manhole = man + hole
manhood = man + hood
mankind = man + kind
manpower = man + power
manservant = man + servant
manslaughter = man + slaughter
mantic = man + tic
mantlepiece = mantle + piece
mantrap = man + trap
manumitted = manumit + ted
margin = mar + gin
marginalia = margin + alia
marketplace = market + place
marketwise = market + wise
marmot = mar + mot
marriageable = marriage + able
marrow = mar + row
marrowbone = marrow + bone
marshland = marsh + land
marshmallow = marsh + mallow
marten = mar + ten
martensite = marten + site
martin = mar + tin
martingale = martin + gale
massacre = mass + acre
massage = mass + age
matchbook = match + book
matchmake = match + make
mattress = mat + tress
maxwell = max + well
mayapple = may + apple
mayhem = may + hem
mayoral = may + oral
meadowland = meadow + land
meadowsweet = meadow + sweet
mealtime = meal + time
meantime = mean + time
meanwhile = mean + while
medallion = medal + lion
medicate = medic + ate
melodramatic = melodrama + tic
meltdown = melt + down
meltwater = melt + water
menace = men + ace
menfolk = men + folk
mentor = men + tor
merrymake = merry + make
message = mess + age
metalwork = metal + work
metropolis = metro + polis
mettlesome = mettle + some
microfiche = micro + fiche
microjoule = micro + joule
midband = mid + band
midday = mid + day
middleman = middle + man
middlemen = middle + men
middleweight = middle + weight
midget = mid + get
midland = mid + land
midmorn = mid + morn
midnight = mid + night
midpoint = mid + point
midrange = mid + range
midscale = mid + scale
midsection = mid + section
midshipman = mid + shipman
midshipmen = mid + shipmen
midspan = mid + span
midstream = mid + stream
midstream = midst + ream
midterm = mid + term
midway = mid + way
midweek = mid + week
midwife = mid + wife
midwinter = mid + winter
mignon = mig + non
migrant = mig + rant
migrate = mig + rate
mileage = mile + age
milestone = mile + stone
militiamen = militia + men
milkweed = milk + weed
million = mill + ion
millstone = mill + stone
mimicking = mimic + king
mincemeat = mince + meat
minefield = mine + field
minibike = mini + bike
minimax = mini + max
minimum = mini + mum
minion = min + ion
minnow = min + now
minuteman = minute + man
minutemen = minute + men
mission = miss + ion
mobcap = mob + cap
moderate = mode + rate
moldboard = mold + board
molehill = mole + hill
moneymake = money + make
moonlight = moon + light
moonlit = moon + lit
moreover = more + over
mortgage = mort + gage
mothball = moth + ball
mother = mot + her
motherhood = mother + hood
motherland = mother + land
motion = mot + ion
motorcycle = motor + cycle
mountainside = mountain + side
mouthpiece = mouth + piece
muddlehead = muddle + head
mudguard = mud + guard
mudsling = mud + sling
mullion = mull + ion
multipliable = multi + pliable
multiply = multi + ply
mushroom = mush + room
musicale = music + ale
muskmelon = musk + melon
muskoxen = musk + oxen
muskrat = musk + rat
mustache = must + ache
nameable = name + able
nameplate = name + plate
namesake = name + sake
napkin = nap + kin
nationhood = nation + hood
nationwide = nation + wide
necklace = neck + lace
neckline = neck + line
necktie = neck + tie
needham = need + ham
needlepoint = needle + point
needlework = needle + work
neonate = neon + ate
nether = net + her
netherworld = nether + world
nettlesome = nettle + some
network = net + work
newborn = new + born
newfound = new + found
newline = new + line
newspaperman = newspaper + man
newspapermen = newspaper + men
newton = new + ton
nickname = nick + name
nightcap = night + cap
nightclub = night + club
nightdress = night + dress
nightfall = night + fall
nightgown = night + gown
nighthawk = night + hawk
nightmare = night + mare
nightshirt = night + shirt
nighttime = night + time
nilpotent = nil + potent
ninebark = nine + bark
ninefold = nine + fold
nineteen = nine + teen
nitpick = nit + pick
nitrate = nit + rate
nitride = nit + ride
nitrite = nit + rite
nobleman = noble + man
noblemen = noble + men
noisemake = noise + make
noontime = noon + time
northbound = north + bound
northeast = north + east
northeastern = north + eastern
northernmost = northern + most
northland = north + land
northward = north + ward
northwest = north + west
northwestern = north + western
nosebag = nose + bag
nosebleed = nose + bleed
notate = not + ate
notebook = note + book
noteworthy = note + worthy
notice = not + ice
noticeable = notice + able
notion = not + ion
nowhere = now + here
nutate = nut + ate
nutcrack = nut + crack
nuthatch = nut + hatch
nutshell = nut + shell
oakwood = oak + wood
oatmeal = oat + meal
obsession = obsess + ion
occultate = occult + ate
occurred = occur + red
occurrent = occur + rent
occurring = occur + ring
oceanside = ocean + side
offbeat = off + beat
offend = off + end
offertory = offer + tory
offhand = off + hand
office = off + ice
officemate = office + mate
offload = off + load
offprint = off + print
offsaddle = off + saddle
offset = off + set
offshoot = off + shoot
offshore = off + shore
offspring = off + spring
offstage = off + stage
ohmmeter = ohm + meter
oilcloth = oil + cloth
oilman = oil + man
oilmen = oil + men
oilseed = oil + seed
omitted = omit + ted
oneself = one + self
onetime = one + time
operatic = opera + tic
opinionate = opinion + ate
oppression = oppress + ion
option = opt + ion
orangeroot = orange + root
originate = origin + ate
orphanage = orphan + age
otherwise = other + wise
otherworld = other + world
ourselves = our + selves
ovenbird = oven + bird
overhang = over + hang
oxygenate = oxygen + ate
pacemake = pace + make
package = pack + age
paddock = pad + dock
padlock = pad + lock
pageant = page + ant
paintbrush = paint + brush
pairwise = pair + wise
palace = pal + ace
palate = pal + ate
pallet = pal + let
pallid = pal + lid
palmate = pal + mate
palmate = palm + ate
pancake = pan + cake
panhandle = pan + handle
panicky = pan + icky
pantheism = pan + theism
pantheist = pan + theist
panther = pant + her
pantry = pan + try
paperback = paper + back
paperbound = paper + bound
paperweight = paper + weight
paperwork = paper + work
paramount = par + amount
paraxial = par + axial
parboil = par + boil
pardon = par + don
parentage = parent + age
parenthood = parent + hood
parkland = park + land
parkway = park + way
parlance = par + lance
parlay = par + lay
parrot = par + rot
parsnip = par + snip
parson = par + son
parsonage = parson + age
partake = par + take
partook = par + took
partridge = part + ridge
passage = pass + age
passageway = passage + way
passband = pass + band
passion = pass + ion
passionate = passion + ate
passport = pass + port
password = pass + word
pasteboard = paste + board
pastoral = past + oral
patchwork = patch + work
pathfind = path + find
pathway = path + way
patriot = pat + riot
patrolled = patrol + led
patrolman = patrol + man
patrolmen = patrol + men
patronage = patron + age
pattern = pat + tern
pawnshop = pawn + shop
paycheck = pay + check
payday = pay + day
payoff = pay + off
payroll = pay + roll
peaceable = peace + able
peacemake = peace + make
peacetime = peace + time
peacock = pea + cock
peafowl = pea + fowl
peanut = pea + nut
pearlstone = pearl + stone
peasanthood = peasant + hood
peephole = peep + hole
pegboard = peg + board
penchant = pen + chant
pendant = pend + ant
penman = pen + man
penmen = pen + men
pennyroyal = penny + royal
penthouse = pent + house
penultimate = pen + ultimate
penumbra = pen + umbra
peptide = pep + tide
percent = per + cent
percentage = percent + age
perception = percept + ion
perchance = per + chance
perchlorate = per + chlorate
perforce = per + force
perform = per + form
perfume = per + fume
perfuse = per + fuse
perfusion = per + fusion
perjure = per + jure
perjury = per + jury
permission = per + mission
permissive = per + missive
permitted = permit + ted
permute = per + mute
peroxide = per + oxide
persevere = per + severe
person = per + son
personage = person + age
perspire = per + spire
perturbate = perturb + ate
peruse = per + use
pervade = per + vade
perverse = per + verse
perversion = per + version
petition = petit + ion
phonetic = phone + tic
phrasemake = phrase + make
pickaxe = pick + axe
pickoff = pick + off
picnicking = picnic + king
piecemeal = piece + meal
piecewise = piece + wise
pigeonberry = pigeon + berry
pigeonfoot = pigeon + foot
pigeonhole = pigeon + hole
piggyback = piggy + back
pigpen = pig + pen
pigroot = pig + root
pigskin = pig + skin
pigtail = pig + tail
pilferage = pilfer + age
pilgrimage = pilgrim + age
pillage = pill + age
pinball = pin + ball
pincushion = pin + cushion
pineapple = pine + apple
pinhead = pin + head
pinhole = pin + hole
pinion = pin + ion
pinpoint = pin + point
pintail = pin + tail
pintail = pint + ail
pinwheel = pin + wheel
pipeline = pipe + line
pitchfork = pitch + fork
pitchstone = pitch + stone
pitfall = pit + fall
pitman = pit + man
placeable = place + able
planeload = plane + load
plankton = plank + ton
platelet = plate + let
platform = plat + form
playback = play + back
playboy = play + boy
playground = play + ground
playhouse = play + house
playmate = play + mate
playoff = play + off
playroom = play + room
plaything = play + thing
playtime = play + time
playwright = play + wright
pleasure = plea + sure
plugboard = plug + board
pluggable = plug + gable
plumage = plum + age
plumbago = plumb + ago
plumbate = plum + bate
plumbate = plumb + ate
plummet = plum + met
plyscore = ply + score
plywood = ply + wood
pocketbook = pocket + book
pointwise = point + wise
poison = poi + son
polecat = pole + cat
police = pol + ice
policeman = police + man
policemen = police + men
policy = pol + icy
politicking = politic + king
polkadot = polka + dot
pollock = pol + lock
pollute = pol + lute
polopony = polo + pony
pontificate = pontific + ate
popcorn = pop + corn
portage = port + age
portend = port + end
portfolio = port + folio
portland = port + land
portray = port + ray
position = posit + ion
posseman = posse + man
possemen = posse + men
possession = possess + ion
postage = post + age
postcard = post + card
postcondition = post + condition
postdoctoral = post + doctoral
postfix = post + fix
postgraduate = post + graduate
postman = post + man
postmark = post + mark
postmen = post + men
postmortem = post + mortem
postmultiply = post + multiply
postorder = post + order
postpaid = post + paid
postposition = post + position
postprocess = post + process
postprocessor = post + processor
postscript = post + script
postwar = post + war
potable = pot + able
potash = pot + ash
potbelly = pot + belly
potboil = pot + boil
potentate = potent + ate
pothole = pot + hole
potion = pot + ion
potlatch = pot + latch
powderpuff = powder + puff
powerhouse = power + house
praiseworthy = praise + worthy
precession = precess + ion
precision = precis + ion
preemption = preempt + ion
preferred = prefer + red
preferring = prefer + ring
prepare = prep + are
prescription = prescript + ion
prevention = prevent + ion
primate = prim + ate
primrose = prim + rose
printmake = print + make
printout = print + out
probate = pro + bate
procession = pro + cession
procession = process + ion
proclaim = pro + claim
procreate = pro + create
procure = pro + cure
product = pro + duct
profession = profess + ion
profile = pro + file
profit = pro + fit
profound = pro + found
profuse = pro + fuse
profusion = pro + fusion
progression = progress + ion
prohibition = prohibit + ion
prolate = pro + late
proline = pro + line
prolong = pro + long
prolongate = prolong + ate
promotion = pro + motion
pronoun = pro + noun
pronounceable = pronounce + able
proofread = proof + read
propane = pro + pane
propelled = propel + led
proper = pro + per
proportionate = proportion + ate
propose = pro + pose
proposition = pro + position
propound = pro + pound
prorate = pro + rate
prorogue = pro + rogue
proscribe = pro + scribe
proscription = pro + scription
prosecute = prose + cute
prostate = pro + state
protease = pro + tease
protectorate = protect + orate
protectorate = protector + ate
protest = pro + test
protestant = protest + ant
proton = pro + ton
protract = pro + tract
proverb = pro + verb
provide = pro + vide
provision = pro + vision
psychoacoustic = psycho + acoustic
psychoanalysis = psycho + analysis
psychoanalyst = psycho + analyst
psychoanalytic = psycho + analytic
psychobiology = psycho + biology
psychopath = psycho + path
psychophysic = psycho + physic
psychopomp = psycho + pomp
psychosis = psycho + sis
psychosomatic = psycho + somatic
psychotherapy = psycho + therapy
psychotic = psycho + tic
puddingstone = pudding + stone
puffball = puff + ball
pullback = pull + back
pullover = pull + over
pumpkin = pump + kin
pumpkinseed = pumpkin + seed
pungent = pun + gent
pupate = pup + ate
puppet = pup + pet
pushbutton = push + button
pushout = push + out
pushpin = push + pin
quadrant = quad + rant
quahog = qua + hog
quarrelsome = quarrel + some
quarryman = quarry + man
quarrymen = quarry + men
quasicontinuous = quasi + continuous
quasiorder = quasi + order
quasiparticle = quasi + particle
quasiperiodic = quasi + periodic
quasistationary = quasi + stationary
quaternary = qua + ternary
quatrain = qua + train
question = quest + ion
quicklime = quick + lime
quicksand = quick + sand
quicksilver = quick + silver
quickstep = quick + step
quintessence = quint + essence
quintessential = quint + essential
quipping = quip + ping
quorum = quo + rum
racetrack = race + track
raceway = race + way
radioastronomy = radio + astronomy
radiocarbon = radio + carbon
radiochemistry = radio + chemistry
radiometer = radio + meter
radiotelegraph = radio + telegraph
radiotelephone = radio + telephone
radiotherapy = radio + therapy
ragout = rag + out
ragweed = rag + weed
railbird = rail + bird
railhead = rail + head
railroad = rail + road
railway = rail + way
rainbow = rain + bow
raincoat = rain + coat
raindrop = rain + drop
rainfall = rain + fall
rainstorm = rain + storm
rampage = ram + page
rampage = ramp + age
rampant = ram + pant
rampant = ramp + ant
rampart = ram + part
rampart = ramp + art
ramrod = ram + rod
rangeland = range + land
ransack = ran + sack
rapport = rap + port
raspberry = rasp + berry
rather = rat + her
rattail = rat + tail
rattlesnake = rattle + snake
rawhide = raw + hide
razorback = razor + back
readout = read + out
realtor = real + tor
rebelled = rebel + led
rebellion = rebel + lion
rebutted = rebut + ted
recession = recess + ion
recurred = recur + red
recurrent = recur + rent
recurring = recur + ring
redact = red + act
redactor = red + actor
redbird = red + bird
redbud = red + bud
redcoat = red + coat
redden = red + den
reddish = red + dish
redhead = red + head
redneck = red + neck
redpoll = red + poll
redshank = red + shank
redstart = red + start
redtop = red + top
redwood = red + wood
reedbuck = reed + buck
referable = refer + able
referred = refer + red
referring = refer + ring
regression = regress + ion
regrettable = regret + table
regretted = regret + ted
reindeer = rein + deer
reinforce = rein + force
reinstate = rein + state
remission = remiss + ion
remitted = remit + ted
repairman = rep + airman
repairmen = rep + airmen
repeat = rep + eat
repeater = rep + eater
repelled = repel + led
repellent = repel + lent
repentant = repent + ant
reprise = rep + rise
reproach = rep + roach
reptile = rep + tile
resistant = resist + ant
restrain = rest + rain
restroom = rest + room
resultant = result + ant
retail = ret + ail
retardant = retard + ant
retire = ret + ire
retrofitted = retrofit + ted
retrogression = retrogress + ion
return = ret + urn
reverberate = rever + berate
revere = rev + ere
reverend = rever + end
ribbon = rib + bon
rickshaw = rick + shaw
riddance = rid + dance
ridden = rid + den
ridgepole = ridge + pole
rifleman = rifle + man
riflemen = rifle + men
rightmost = right + most
rightward = right + ward
ringlet = ring + let
ringside = ring + side
ripoff = rip + off
riverbank = river + bank
riverfront = river + front
riverside = river + side
roadbed = road + bed
roadblock = road + block
roadhouse = road + house
roadside = road + side
roadway = road + way
robbin = rob + bin
rockaway = rock + away
rockbound = rock + bound
roebuck = roe + buck
rollback = roll + back
rooftop = roof + top
rooftree = roof + tree
roommate = room + mate
rosebud = rose + bud
rosebush = rose + bush
rotate = rot + ate
rotenone = rote + none
rotten = rot + ten
roughcast = rough + cast
roughneck = rough + neck
roughshod = rough + shod
roundabout = round + about
roundhead = round + head
roundhouse = round + house
roundoff = round + off
roundtable = round + table
roundworm = round + worm
rowboat = row + boat
rubdown = rub + down
rumpus = rum + pus
runabout = run + about
runaway = run + away
rundown = run + down
runoff = run + off
runway = run + way
rustproof = rust + proof
sachem = sac + hem
sacred = sac + red
sadden = sad + den
saddlebag = saddle + bag
safeguard = safe + guard
sagacity = saga + city
sagebrush = sage + brush
sailboat = sail + boat
sailfish = sail + fish
sainthood = saint + hood
salmonberry = salmon + berry
saloonkeep = saloon + keep
saltbush = salt + bush
saltwater = salt + water
salvageable = salvage + able
sandalwood = sandal + wood
sandbag = sand + bag
sandblast = sand + blast
sandhill = sand + hill
sandman = sand + man
sandpaper = sand + paper
sandpile = sand + pile
sandstone = sand + stone
satire = sat + ire
saucepan = sauce + pan
sawbelly = saw + belly
sawdust = saw + dust
sawfish = saw + fish
sawfly = saw + fly
sawmill = saw + mill
sawtimber = saw + timber
sawtooth = saw + tooth
scabbard = scab + bard
scarecrow = scare + crow
scarface = scar + face
scarface = scarf + ace
scarlet = scar + let
schematic = schema + tic
schoolbook = school + book
schoolboy = school + boy
schoolgirl = school + girl
schoolgirlish = school + girlish
schoolhouse = school + house
schoolmate = school + mate
schoolroom = school + room
schoolwork = school + work
scoreboard = score + board
scorecard = score + card
scrapbook = scrap + book
screenplay = screen + play
screwball = screw + ball
screwbean = screw + bean
screwworm = screw + worm
scription = script + ion
seaboard = sea + board
seacoast = sea + coast
seafare = sea + fare
seafood = sea + food
seagull = sea + gull
seahorse = sea + horse
sealant = seal + ant
seaman = sea + man
seamen = sea + men
seamstress = seam + stress
seaport = sea + port
seaquake = sea + quake
searchlight = search + light
seashore = sea + shore
seaside = sea + side
season = sea + son
seaward = sea + ward
seaweed = sea + weed
secant = sec + ant
secondhand = second + hand
secret = sec + ret
secretion = secret + ion
section = sect + ion
sector = sec + tor
sectoral = sect + oral
seeable = see + able
seedbed = seed + bed
seepage = see + page
seepage = seep + age
seethe = see + the
seething = see + thing
selectman = select + man
selectmen = select + men
selfadjoint = self + adjoint
sellout = sell + out
seminary = semi + nary
senate = sen + ate
sentry = sen + try
septate = sept + ate
sergeant = serge + ant
serviceable = service + able
serviceberry = service + berry
serviceman = service + man
servicemen = service + men
servomechanism = servo + mechanism
setback = set + back
setscrew = set + screw
sevenfold = seven + fold
seventeen = seven + teen
severalfold = several + fold
sewage = sew + age
sexton = sex + ton
sextuple = sex + tuple
shadbush = shad + bush
shagbark = shag + bark
shakeable = shake + able
shakedown = shake + down
shameface = shame + face
shamrock = sham + rock
sharecrop = share + crop
shareown = share + own
sharpshoot = sharp + shoot
shatterproof = shatter + proof
sheepskin = sheep + skin
shinbone = shin + bone
shipboard = ship + board
shipbuild = ship + build
shiplap = ship + lap
shipman = ship + man
shipmate = ship + mate
shipmen = ship + men
shipshape = ship + shape
shipwreck = ship + wreck
shipyard = ship + yard
shirtmake = shirt + make
shoehorn = shoe + horn
shoelace = shoe + lace
shoemake = shoe + make
shoestring = shoe + string
shoofly = shoo + fly
shopkeep = shop + keep
shopworn = shop + worn
shoreline = shore + line
shortage = short + age
shortcut = short + cut
shortfall = short + fall
shorthand = short + hand
shortstop = short + stop
shotbush = shot + bush
shotgun = shot + gun
showboat = show + boat
showcase = show + case
showdown = show + down
showman = show + man
showmen = show + men
showpiece = show + piece
showplace = show + place
showroom = show + room
shrinkage = shrink + age
shuffleboard = shuffle + board
shutdown = shut + down
shutoff = shut + off
shutout = shut + out
shuttlecock = shuttle + cock
sicken = sic + ken
sickroom = sick + room
sidearm = side + arm
sideband = side + band
sideboard = side + board
sidecar = side + car
sidelight = side + light
sideline = side + line
sidelong = side + long
sideman = side + man
sidemen = side + men
sidereal = side + real
siderite = side + rite
sidesaddle = side + saddle
sideshow = side + show
sidestep = side + step
sidestepping = sidestep + ping
sidetrack = side + track
sidewalk = side + walk
sidewall = side + wall
sideway = side + way
sidewise = side + wise
sightsee = sight + see
sightseeing = sight + seeing
signboard = sign + board
signpost = sign + post
silkworm = silk + worm
siltstone = silt + stone
silversmith = silver + smith
silverware = silver + ware
simpleton = simple + ton
singable = sin + gable
singable = sing + able
singlet = sing + let
singleton = single + ton
singsong = sing + song
sinkhole = sink + hole
siskin = sis + kin
situate = situ + ate
sixfold = six + fold
sixgun = six + gun
sixteen = six + teen
sketchbook = sketch + book
sketchpad = sketch + pad
skindive = skin + dive
skipjack = skip + jack
skullcap = skull + cap
skyhook = sky + hook
skyjack = sky + jack
skylark = sky + lark
skylight = sky + light
skyline = sky + line
skyrocket = sky + rocket
skyscrape = sky + scrape
skyward = sky + ward
skywave = sky + wave
skyway = sky + way
slapstick = slap + stick
slaughterhouse = slaughter + house
sleepwalk = sleep + walk
slingshot = sling + shot
slippage = slip + page
slither = slit + her
slowdown = slow + down
smalltime = small + time
smokehouse = smoke + house
smokescreen = smoke + screen
smokestack = smoke + stack
smoothbore = smooth + bore
snakebird = snake + bird
snakelike = snake + like
snakeroot = snake + root
snapback = snap + back
snapdragon = snap + dragon
snapshot = snap + shot
snippet = snip + pet
snowball = snow + ball
snowfall = snow + fall
snowflake = snow + flake
snowmobile = snow + mobile
snowshoe = snow + shoe
snowstorm = snow + storm
soapstone = soap + stone
soapsud = soap + sud
sockeye = sock + eye
sodden = sod + den
softball = soft + ball
software = soft + ware
softwood = soft + wood
somatic = soma + tic
somebody = some + body
someday = some + day
somehow = some + how
someone = some + one
someplace = some + place
something = some + thing
sometime = some + time
somewhat = some + what
somewhere = some + where
sonant = son + ant
songbag = song + bag
songbook = song + book
sonnet = son + net
soothsay = sooth + say
soundproof = sound + proof
sourberry = sour + berry
sourdough = sour + dough
sourwood = sour + wood
southbound = south + bound
southeast = south + east
southeastern = south + eastern
southernmost = southern + most
southland = south + land
southpaw = south + paw
southward = south + ward
southwest = south + west
southwestern = south + western
sowbelly = sow + belly
soybean = soy + bean
spacecraft = space + craft
spacesuit = space + suit
spacetime = space + time
sparrow = spar + row
speakeasy = speak + easy
spearhead = spear + head
spearmint = spear + mint
speedboat = speed + boat
speedwell = speed + well
spellbound = spell + bound
spicebush = spice + bush
spinoff = spin + off
spitfire = spit + fire
spoilage = spoil + age
sportswear = sport + swear
spotlight = spot + light
springboard = spring + board
springtail = spring + tail
springtime = spring + time
spyglass = spy + glass
squashberry = squash + berry
squatted = squat + ted
squawbush = squaw + bush
squawroot = squaw + root
squirehood = squire + hood
stableman = stable + man
stablemen = stable + men
stagecoach = stage + coach
stagestruck = stage + struck
staircase = stair + case
stairway = stair + way
stairwell = stair + well
stalemate = stale + mate
stallion = stall + ion
stanchion = stanch + ion
standoff = stand + off
standpoint = stand + point
standstill = stand + still
starboard = star + board
starfish = star + fish
stargaze = star + gaze
starlet = star + let
starlight = star + light
stateroom = state + room
statesmanlike = statesman + like
statewide = state + wide
steadfast = stead + fast
stealthy = steal + thy
steamboat = steam + boat
steelmake = steel + make
steeplebush = steeple + bush
steeplechase = steeple + chase
stepchild = step + child
stepmother = step + mother
stepson = step + son
stepwise = step + wise
stickleback = stickle + back
stickpin = stick + pin
sticktight = stick + tight
stillbirth = still + birth
stillwater = still + water
stinkpot = stink + pot
stockpile = stock + pile
stockroom = stock + room
stonecrop = stone + crop
stonewall = stone + wall
stoneware = stone + ware
stopband = stop + band
stopcock = stop + cock
stopgap = stop + gap
stopover = stop + over
stoppage = stop + page
stopwatch = stop + watch
storehouse = store + house
storekeep = store + keep
storeroom = store + room
stormbound = storm + bound
storyboard = story + board
storyteller = story + teller
stowage = stow + age
stowaway = stow + away
straightaway = straight + away
straightway = straight + way
stratagem = strata + gem
strawberry = straw + berry
streamline = stream + line
streamside = stream + side
streetcar = street + car
strikebreak = strike + break
striptease = strip + tease
stronghold = strong + hold
strongroom = strong + room
stubborn = stub + born
stumpage = stump + age
submitted = submit + ted
succession = success + ion
sudden = sud + den
suggestion = suggest + ion
suitcase = suit + case
sultanate = sultan + ate
summate = sum + mate
sunbeam = sun + beam
sunbonnet = sun + bonnet
sunburn = sun + burn
sunburnt = sun + burnt
sundew = sun + dew
sundial = sun + dial
sundown = sun + down
sundry = sun + dry
sunfish = sun + fish
sunken = sun + ken
sunlight = sun + light
sunlit = sun + lit
sunrise = sun + rise
sunscreen = sun + screen
sunset = sun + set
sunshade = sun + shade
sunshine = sun + shine
sunshiny = sun + shiny
sunspot = sun + spot
suntan = sun + tan
superlunary = super + lunary
superposable = super + posable
supplant = sup + plant
supply = sup + ply
support = sup + port
supposable = sup + posable
suppose = sup + pose
supposition = sup + position
suppress = sup + press
suppression = suppress + ion
surface = surf + ace
swallowtail = swallow + tail
swanlike = swan + like
sweatband = sweat + band
sweatshirt = sweat + shirt
sweepstake = sweep + stake
sweetheart = sweet + heart
swimsuit = swim + suit
swingable = swing + able
switchblade = switch + blade
switchboard = switch + board
switchgear = switch + gear
switchman = switch + man
swordfish = sword + fish
swordplay = sword + play
swordtail = sword + tail
syndicate = syndic + ate
systemwide = system + wide
tablecloth = table + cloth
tableland = table + land
tablespoon = table + spoon
tablespoonful = table + spoonful
tablet = tab + let
tabulate = tabu + late
tadpole = tad + pole
tailgate = tail + gate
tailspin = tail + spin
tailwind = tail + wind
takeoff = take + off
takeover = take + over
tamale = tam + ale
tangent = tan + gent
tapeworm = tape + worm
tappet = tap + pet
target = tar + get
tarpaper = tar + paper
tartar = tar + tar
tattletale = tattle + tale
tattoo = tat + too
taxicab = taxi + cab
taxiway = taxi + way
teacart = tea + cart
teacup = tea + cup
teahouse = tea + house
teakettle = tea + kettle
teammate = team + mate
teamwork = team + work
teapot = tea + pot
teardrop = tear + drop
teaspoon = tea + spoon
teaspoonful = tea + spoonful
teenage = teen + age
teethe = tee + the
teething = tee + thing
teetotal = tee + total
teletypewrite = teletype + write
telltale = tell + tale
temperate = temper + ate
tenable = ten + able
tenant = ten + ant
tendon = ten + don
tenfold = ten + fold
tenspot = ten + spot
testate = test + ate
testbed = test + bed
textbook = text + book
themselves = them + selves
thenceforth = thence + forth
therefor = there + for
therefore = there + fore
therefrom = there + from
therein = the + rein
theretofore = thereto + fore
thereunder = there + under
thereupon = there + upon
therewith = there + with
thesis = the + sis
thistledown = thistle + down
thoroughbred = thorough + bred
thoroughfare = thorough + fare
thousand = thou + sand
thousandfold = thousand + fold
threadbare = thread + bare
threefold = three + fold
threesome = three + some
threshold = thresh + old
throughout = through + out
throughput = through + put
throwaway = throw + away
throwback = throw + back
thuggee = thug + gee
thumbnail = thumb + nail
thunderbird = thunder + bird
thunderbolt = thunder + bolt
thunderclap = thunder + clap
thunderstorm = thunder + storm
thymine = thy + mine
tidbit = tid + bit
tideland = tide + land
tidewater = tide + water
timberland = timber + land
timeout = time + out
timepiece = time + piece
timeshare = time + share
timetable = time + table
timeworn = time + worn
tinfoil = tin + foil
tintype = tin + type
tipoff = tip + off
tiptoe = tip + toe
tiresome = tire + some
titmouse = tit + mouse
titrate = tit + rate
toenail = toe + nail
together = tog + ether
toilsome = toil + some
tollgate = toll + gate
tollhouse = toll + house
tombstone = tomb + stone
toolkit = tool + kit
toolmake = tool + make
toolsmith = tool + smith
toothbrush = tooth + brush
toothpaste = tooth + paste
toothpick = tooth + pick
topcoat = top + coat
topgallant = top + gallant
topmost = top + most
topnotch = top + notch
topsoil = top + soil
torrent = tor + rent
torrid = tor + rid
tortoiseshell = tortoise + shell
touchdown = touch + down
touchstone = touch + stone
towboat = tow + boat
towhead = tow + head
townhouse = town + house
traceable = trace + able
trackage = track + age
trademark = trade + mark
tradeoff = trade + off
trafficking = traffic + king
trailblaze = trail + blaze
trailhead = trail + head
trailside = trail + side
trainman = train + man
trainmen = train + men
tramway = tram + way
transcription = transcript + ion
transferable = transfer + able
transferred = transfer + red
transferring = transfer + ring
transgression = transgress + ion
transition = transit + ion
transmittable = transmit + table
transmitted = transmit + ted
transshipping = transship + ping
traumatic = trauma + tic
treadmill = tread + mill
treetop = tree + top
trenchant = trench + ant
trigram = trig + ram
trillion = trill + ion
trimester = trim + ester
triplet = trip + let
triumphant = triumph + ant
trodden = trod + den
troubleshoot = trouble + shoot
troublesome = trouble + some
trustworthy = trust + worthy
tungstate = tung + state
turnabout = turn + about
turnaround = turn + around
turnkey = turn + key
turnoff = turn + off
turnout = turn + out
turnover = turn + over
turnpike = turn + pike
turnstone = turn + stone
turntable = turn + table
turtleback = turtle + back
turtleneck = turtle + neck
twofold = two + fold
twosome = two + some
typeface = type + face
typescript = type + script
typeset = type + set
typewrite = type + write
typewritten = type + written
ulcerate = ulcer + ate
uppercut = upper + cut
uppermost = upper + most
uttermost = utter + most
vacuolate = vacuo + late
vainglorious = vain + glorious
valediction = vale + diction
validate = valid + ate
vampire = vamp + ire
vanguard = van + guard
venturesome = venture + some
versatile = versa + tile
viaduct = via + duct
videotape = video + tape
viewpoint = view + point
viewport = view + port
vigilant = vigil + ant
vigilante = vigil + ante
vinegar = vine + gar
vineyard = vine + yard
visage = vis + age
viscount = vis + count
vision = vis + ion
vitamin = vita + min
vivacity = viva + city
voiceband = voice + band
volleyball = volley + ball
voltage = volt + age
voltmeter = volt + meter
vouchsafe = vouch + safe
waistcoat = waist + coat
waistline = waist + line
wakerobin = wake + robin
walkout = walk + out
walkover = walk + over
walkway = walk + way
wallboard = wall + board
wallpaper = wall + paper
wanton = wan + ton
warden = war + den
wardrobe = ward + robe
wardroom = ward + room
warehouse = ware + house
warehouseman = warehouse + man
warfare = war + fare
warhead = war + head
warlike = war + like
warplane = war + plane
warplane = warp + lane
warrant = war + rant
wartime = war + time
washbasin = wash + basin
washboard = wash + board
washbowl = wash + bowl
washout = wash + out
wastage = wast + age
wastebasket = waste + basket
wasteland = waste + land
wastewater = waste + water
watchband = watch + band
watchdog = watch + dog
watchmake = watch + make
watchman = watch + man
watchmen = watch + men
watchword = watch + word
watercourse = water + course
waterfall = water + fall
waterfront = water + front
waterline = water + line
watermelon = water + melon
waterproof = water + proof
watershed = water + shed
waterside = water + side
waterway = water + way
wattage = watt + age
waveform = wave + form
wavefront = wave + front
waveguide = wave + guide
wavelength = wave + length
wavelet = wave + let
waxwork = wax + work
waybill = way + bill
waylaid = way + laid
waylay = way + lay
wayside = way + side
wayward = way + ward
wealthy = weal + thy
weatherbeaten = weather + beaten
weatherproof = weather + proof
weatherstrip = weather + strip
wedlock = wed + lock
weekday = week + day
weekend = week + end
wellbeing = well + being
westbound = west + bound
westernmost = western + most
westward = west + ward
wetland = wet + land
whatnot = what + not
wheelbase = wheel + base
wheelchair = wheel + chair
wheelhouse = wheel + house
whereabout = where + about
wherefore = where + fore
whereupon = where + upon
wherewith = where + with
wherewithal = where + withal
whether = whet + her
whimper = whim + per
whimsic = whim + sic
whiplash = whip + lash
whippet = whip + pet
whipsaw = whip + saw
whirlpool = whirl + pool
whirlwind = whirl + wind
whistleable = whistle + able
whiteface = white + face
whitehead = white + head
whitetail = white + tail
whitewash = white + wash
whither = whit + her
whizzing = whiz + zing
wholesale = whole + sale
wholesome = whole + some
widespread = wide + spread
widowhood = widow + hood
widthwise = width + wise
wigmake = wig + make
wildcat = wild + cat
wildfire = wild + fire
wildlife = wild + life
windbag = wind + bag
windbreak = wind + break
windfall = wind + fall
windmill = wind + mill
windowpane = window + pane
windowsill = window + sill
windshield = wind + shield
windstorm = wind + storm
windsurf = wind + surf
windward = wind + ward
winemake = wine + make
wineskin = wine + skin
wingback = wing + back
wingman = wing + man
wingmen = wing + men
wingspan = wing + span
wingtip = wing + tip
winnow = win + now
winsome = win + some
wintertime = winter + time
wintry = win + try
wireman = wire + man
wiremen = wire + men
wiretap = wire + tap
wiretapper = wiretap + per
wiretapping = wiretap + ping
wiseacre = wise + acre
wisecrack = wise + crack
wishbone = wish + bone
witchcraft = witch + craft
withdraw = with + draw
withdrawn = with + drawn
withdrew = with + drew
wither = wit + her
withheld = with + held
withhold = with + hold
without = with + out
withstand = with + stand
withstood = with + stood
womanhood = woman + hood
wonderland = wonder + land
woodcock = wood + cock
woodcut = wood + cut
wooden = woo + den
woodgrain = wood + grain
woodhen = wood + hen
woodland = wood + land
woodlot = wood + lot
woodpeck = wood + peck
woodrow = wood + row
woodruff = wood + ruff
woodshed = wood + shed
woodside = wood + side
woodward = wood + ward
woodwind = wood + wind
woodwork = wood + work
woodyard = wood + yard
woolgather = wool + gather
workbench = work + bench
workbook = work + book
workday = work + day
workforce = work + force
workhorse = work + horse
workload = work + load
workman = work + man
workmanlike = workman + like
workmen = work + men
workout = work + out
workpiece = work + piece
workplace = work + place
worksheet = work + sheet
workshop = work + shop
workspace = work + space
worktable = work + table
worldwide = world + wide
worthwhile = worth + while
wreckage = wreck + age
wristband = wrist + band
wristwatch = wrist + watch
written = writ + ten
yapping = yap + ping
yardage = yard + age
yardstick = yard + stick
yearbook = year + book
yipping = yip + ping
yourself = your + self
yourselves = your + selves
zigzag = zig + zag
zigzagging = zig + zagging